================================
+______________________________+
+_............................_+
+_%................*.........*_+
+_...........*.........._______+
+_.*!._.............._........_+
+_.__......___........!......*_+
+_..._.._.............___.._.*_+
+_...._.........._...........*_+
+_....._...%...*....!_.....____+
+_.*...._........__._..__....._+
+_.._........__..!.....%%....._+
+_!.....__.......__...___....._+
+__........._........_........_+
+_@....._........__..........*_+
+______________________________+
================================