================================
+______________________________+
+_%%%%....%%.................._+
+__._...@...._.............._._+
+_.._..................______._+
+_.__.....__.........__...._%._+
+_.._......_........__....%_.._+
+__._......_._.....__.._..___._+
+_.._......_......_%_........._+
+_.__......__...._.._....._____+
+_.._....._....._..__........._+
+__._.....__..._.._%_._..._%%%_+
+_.._........._.._.._.___._%%%_+
+_.__........_.._..__....._____+
+_.......................!!!!*_+
+______________________________+
================================