====================================
+__________________________________+
+_................................_+
+_...........*...................*_+
+_.!*..............._..........__._+
+_.___.....___.........!..._......_+
+_......_........__....__........._+
+_..............._%..............._+
+_!...@_......!*!_..!_...........!_+
+__________________________________+
====================================